    WWWWWWWWWWWWWWWWWWWWWWWWWWWWWWWWWWWWWWWW
    W                 1                    W
    W                 2                    W
    W                 3                    W
    W                 4                    W
    W                 5                    W
    W                 6                    W
    W                 7                    W
    W                 8                    W
    W                 9                    W
    W                 10                   W
    W                 11                   W
    W                 12                   W
    W                 13                   W
    WWWWWWWWW         14                   W
    WWWW________      15                   W
    WWW__WWWWWWW      16                   W
    WH__W             17                   W
    W__W              18                   W
    WWWWWWWWWWWWWWWWWWWWWWWWWWWWWWWWWWWWWWWW